year,location,state,dead,injured,total,lat,lon
1982,Miami,Florida,8,3,11,25.784,-80.2102
1984,San Ysidro,California,22,19,41,32.5520013,-117.0430813
1984,Dallas,Texas,6,1,7,32.7937,-96.7662
1986,Edmond,Oklahoma,15,6,21,35.6689,-97.4159
1987,Palm Bay,Florida,6,14,20,27.9861,-80.6628
1988,Sunnyvale,California,7,4,11,37.3835,-122.0257
1989,Stockton,California,6,29,35,37.9766,-121.3112
1989,Louisville,Kentucky,9,12,21,38.1662,-85.6488
1990,Jacksonville,Florida,10,4,14,30.3322,-81.6749
1991,Iowa City,Iowa,6,1,7,41.6559,-91.5304
1991,Royal Oak,Michigan,5,5,10,42.5084,-83.1539
1991,Killeen,Texas,24,20,44,31.0754,-97.7293
1992,Olivehurst,California,4,10,14,39.0817,-121.5549
1992,Watkins Glen,New York,5,0,5,42.3801,-76.8673
1993,San Francisco,California,9,6,15,37.7562,-122.443
1993,Aurora,Colorado,4,1,5,39.7084,-104.7274
1993,Garden City,New York,6,19,25,40.7266,-73.6447
1993,Fayetteville,North Carolina,4,8,12,35.0846,-78.9776
1994,Fairchild Air Force Base,Washington,5,23,28,47.61864486,-117.6483587
1995,Corpus Christi,Texas,6,0,6,27.7173,-97.3822
1996,Fort Lauderdale,Florida,6,1,7,26.1412,-80.1464
1997,Orange,California,5,2,7,33.8038,-117.8219
1997,Aiken,South Carolina,4,3,7,33.5303,-81.727
1998,Jonesboro,Arkansas,5,10,15,35.8212,-90.6795
1998,Newington,Connecticut,5,1,6,41.687,-72.7308
1998,Springfield,Oregon,4,25,29,44.0538,-122.9811
1999,Littleton,Colorado,13,24,37,39.5911,-105.0194
1999,Tampa,Florida,5,3,8,27.9937,-82.4454
1999,Atlanta,Georgia,9,13,22,33.7626,-84.4228
1999,Honolulu,Hawaii,7,0,7,21.3294,-157.846
1999,Fort Worth,Texas,8,7,15,32.7814,-97.3473
2000,Wakefield,Massachusetts,7,0,7,42.5035,-71.0656
2000,Pittsburgh,Pennsylvania,5,0,5,40.4396,-79.9763
2001,Nevada County,California,3,2,5,39.34222222,-120.2036111
2001,Santee,California,2,13,15,32.8555,-116.9856
2001,Melrose Park,Illinois,5,4,9,41.9029,-87.8642
2002,Washington,District of Columbia,17,10,27,38.9047,-77.0163
2002,Grundy,Virginia,3,3,6,37.2754,-82.0988
2003,New Orleans,Louisiana,1,3,4,30.0687,-89.9288
2003,Meridian,Mississippi,7,8,15,32.3846,-88.6897
2004,Fresno,California,9,0,9,36.7834,-119.7941
2004,Columbus,Ohio,5,7,12,39.986,-82.9852
2004,Meteor,Wisconsin,6,2,8,45.67916667,-91.35583333
2005,Red Lake,Minnesota,10,5,15,47.8707,-95.0052
2005,Red Lake,Minnesota,10,5,15,47.8707,-95.0052
2005,Tacoma,Washington,0,6,6,47.2431,-122.4531
2005,Brookfield,Wisconsin,7,4,11,43.064,-88.1232
2006,Goleta,California,8,0,8,34.436,-119.8596
2006,Bart Township,Pennsylvania,6,5,11,39.9589,-76.0806
2006,Seattle,Washington,7,2,9,47.6211,-122.3244
2006,Seattle,Washington,7,2,9,47.6211,-122.3244
2007,Colorado Springs,Colorado,5,5,10,38.8674,-104.7606
2007,Omaha,Nebraska,9,6,15,41.2628,-96.0495
2007,Salt Lake City,Utah,6,4,10,40.7774,-111.9301
2007,Blacksburg,Virginia,32,23,55,37.23,-80.428
2007,Crandon,Wisconsin,7,1,8,45.5686,-88.8973
2008,Covina,California,10,3,13,34.0903,-117.8817
2008,DeKalb,Illinois,6,21,27,41.9312,-88.7483
2008,Henderson,Kentucky,6,1,7,37.8405,-87.5788
2008,Kirkwood,Missouri,6,2,8,38.5789,-90.4203
2008,Skagit County,Washington,6,2,8,48.50194444,-122.6236111
2009,Geneva,Alabama,11,6,17,31.0437,-85.8764
2009,Binghamton,New York,14,4,18,42.1014,-75.9093
2009,Carthage,North Carolina,8,3,11,35.3223,-79.4117
2009,Collier Township,Pennsylvania,4,9,13,40.38333333,-80.11638889
2009,Pittsburgh,Pennsylvania,3,3,6,40.4396,-79.9763
2009,Fort Hood,Texas,14,33,47,31.135557,-97.783664
2009,Parkland,Washington,4,1,5,47.1417,-122.4376
2010,Huntsville,Alabama,3,3,6,34.6989,-86.6414
2010,Manchester,Connecticut,9,2,11,41.7801,-72.5192
2010,St. Louis,Missouri,4,5,9,38.62722222,-90.19777778
2010,Appomattox,Virginia,8,0,8,37.3591,-78.8269
2011,Tucson,Arizona,6,15,21,32.1546,-110.8782
2011,Seal Beach,California,8,1,9,33.7542,-118.0714
2011,Grand Rapids,Michigan,8,2,10,42.9615,-85.6557
2011,Carson City,Nevada,5,7,12,39.1512,-119.7474
2012,Oakland,California,7,3,10,37.7903,-122.2165
2012,Aurora,Colorado,12,70,82,39.7084,-104.7274
2012,Newtown,Connecticut,28,2,30,41.4119,-73.312
2012,Norcross,Georgia,5,0,5,33.9378,-84.2065
2012,Minneapolis,Minnesota,7,1,8,44.9635,-93.2678
2012,New York City,New York,2,9,11,40.7128,-74.01183333
2012,Pleasant Garden,North Carolina,5,1,6,35.9595,-79.7598
2012,Chardon,Ohio,3,3,6,41.5803,-81.2082
2012,Seattle,Washington,6,1,7,47.6211,-122.3244
2012,Oak Creek,Wisconsin,7,4,11,42.8803,-87.9008
2013,Los Angeles,California,1,4,5,34.1139,-118.4068
2013,Los Angeles,California,5,7,12,34.1139,-118.4068
2013,Santa Monica,California,6,5,11,34.0232,-118.4813
2013,Washington,District of Columbia,13,8,21,38.9047,-77.0163
2013,Hialeah,Florida,7,0,7,25.8696,-80.3045
2013,Hialeah,Florida,7,0,7,25.8696,-80.3045
2013,South Valley,New Mexico,5,0,5,35.0093,-106.6819
2013,Herkimer County,New York,5,2,7,43.045601,-74.984891
2013,Saylorsburg,Pennsylvania,3,4,7,40.8998,-75.3179
2013,Federal Way,Washington,5,0,5,47.309,-122.3359
2014,Alturas,California,4,2,6,41.4898,-120.5516
2014,Santa Barbara,California,7,13,20,34.4285,-119.7202
2014,Overland Park,Kansas,3,0,3,38.887,-94.687
2014,Portland,Oregon,0,4,4,45.5372,-122.65
2014,Montgomery County,Pennsylvania,3,12,15,31.141716,-97.777559
2014,Fort Hood,Texas,4,14,18,31.13,-97.68
2014,Spring,Texas,6,1,7,30.0613,-95.383
2014,Marysville,Washington,5,1,6,48.0809,-122.1558
2015,San Bernardino,California,16,22,38,34.1412,-117.2936
2015,Colorado Springs,Colorado,3,9,12,38.8674,-104.7606
2015,Colorado Springs,Colorado,3,0,3,38.8674,-104.7606
2015,Lafayette,Louisiana,3,9,12,30.2083,-92.0322
2015,Minneapolis,Minnesota,0,5,5,44.9635,-93.2678
2015,Tyrone,Missouri,8,1,9,37.20333333,-92.37666667
2015,Roseburg,Oregon,9,9,18,43.2229,-123.3519
2015,Charleston,South Carolina,9,1,10,32.8137,-79.9643
2015,Chattanooga,Tennessee,5,2,7,35.0657,-85.2488
2015,Harris County,Texas,8,0,8,29.67611111,-95.17388889
2015,Waco,Texas,9,18,27,31.5597,-97.1883
2015,Menasha,Wisconsin,3,1,4,44.2125,-88.4271
2016,Citronelle,Alabama,6,0,6,31.0952,-88.2467
2016,Orlando,Florida,50,53,103,28.4788,-81.342
2016,Hesston,Kansas,4,14,18,38.1403,-97.4273
2016,Baton Rouge,Louisiana,4,3,7,30.4423,-91.1314
2016,Beltsville,Maryland,3,3,6,39.0394,-76.9211
2016,Kalamazoo,Michigan,6,2,8,42.2749,-85.5881
2016,St. Joseph,Michigan,3,2,5,42.09805556,-86.48416667
2016,Pike County,Ohio,8,0,8,39.12305556,-83.05083333
2016,Wilkinsburg,Pennsylvania,6,3,9,40.4442,-79.8733
2016,Townville,South Carolina,2,3,5,34.5637,-82.8985
2016,Dallas,Texas,6,11,17,32.7937,-96.7662
2016,Burlington,Washington,5,0,5,48.4677,-122.3298
2016,Mukilteo,Washington,3,1,4,47.9094,-122.3035
2017,Little Rock,Arkansas,0,28,28,34.7255,-92.3581
2017,Fresno,California,4,0,4,36.7834,-119.7941
2017,Rancho Tehama,California,5,10,15,40.018759,-122.393089
2017,San Bernardino,California,3,1,4,34.1412,-117.2936
2017,San Francisco,California,4,5,9,37.7562,-122.443
2017,San Francisco,California,3,2,5,37.7562,-122.443
2017,Highlands Ranch,Colorado,2,6,8,39.5419,-104.9708
2017,Thornton,Colorado,3,0,3,39.9205,-104.9443
2017,Fort Lauderdale,Florida,5,6,11,26.1412,-80.1464
2017,Orlando,Florida,6,0,6,28.4788,-81.342
2017,Edgewood,Maryland,3,3,6,39.421,-76.2968
2017,Lincoln County,Mississippi,8,1,9,31.58194444,-90.44305556
2017,Las Vegas,Nevada,58,546,604,36.2291,-115.2607
2017,Aztec,New Mexico,3,0,3,36.819,-107.9823
2017,Clovis,New Mexico,2,4,6,34.4376,-103.1923
2017,Cincinnati,Ohio,2,16,18,39.1031,-84.512
2017,Kirkersville,Ohio,3,0,3,39.95,-82.5985
2017,Eaton Township,Pennsylvania,4,0,4,41.48333333,-76.03305556
2017,Tunkhannock,Pennsylvania,3,0,3,41.5412,-75.9488
2017,Antioch,Tennessee,1,8,9,36.0597,-86.6716
2017,Plano,Texas,9,1,10,33.0502,-96.7487
2017,Sutherland Springs,Texas,26,20,46,29.273282,-98.056488
2017,Sutherland Springs,Texas,27,20,47,29.2733,-98.0567
2017,Sandy,Utah,3,2,5,40.565,-111.839
2017,Alexandria,Virginia,1,6,7,38.8185,-77.0861
2017,Schofield,Wisconsin,5,0,5,44.9147,-89.6158
2018,Birmingham,Alabama,0,4,4,33.5276,-86.7988
2018,Demopolis,Alabama,2,2,4,32.498,-87.8298
2018,Eutaw,Alabama,1,4,5,32.8436,-87.8987
2018,Huntsville,Alabama,0,4,4,34.6989,-86.6414
2018,Huntsville,Alabama,1,3,4,34.6989,-86.6414
2018,Hurtsboro,Alabama,2,2,4,32.2401,-85.4147
2018,Lowndes County,Alabama,0,6,6,32.1825,-86.58055556
2018,Madison,Alabama,0,4,4,34.7113,-86.7617
2018,Mobile,Alabama,1,4,5,30.6783,-88.1162
2018,Montgomery,Alabama,0,4,4,32.347,-86.2663
2018,Union Springs,Alabama,1,5,6,32.1395,-85.7141
2018,Wetumpka,Alabama,3,2,5,32.5407,-86.2057
2018,Globe,Arizona,2,2,4,33.3869,-110.7514
2018,Phoenix,Arizona,1,4,5,33.5722,-112.0891
2018,Scottsdale,Arizona,7,0,7,33.6872,-111.865
2018,Brinkley,Arkansas,1,3,4,34.8898,-91.1899
2018,El Dorado,Arkansas,2,2,4,33.2184,-92.664
2018,Little Rock,Arkansas,3,1,4,34.7255,-92.3581
2018,Pine Bluff,Arkansas,1,3,4,34.2116,-92.0178
2018,Pine Bluff,Arkansas,0,4,4,34.2116,-92.0178
2018,Bakersfield,California,6,0,6,35.353,-119.036
2018,Clearlake,California,4,1,5,38.959,-122.633
2018,East Palo Alto,California,2,2,4,37.4671,-122.1352
2018,Gardena,California,2,3,5,33.8944,-118.3073
2018,Long Beach,California,0,4,4,33.8059,-118.161
2018,Los Angeles,California,1,3,4,34.1139,-118.4068
2018,Los Angeles,California,0,5,5,34.1139,-118.4068
2018,Los Angeles,California,2,4,6,34.1139,-118.4068
2018,Los Angeles,California,3,3,6,34.1139,-118.4068
2018,Los Angeles,California,2,2,4,34.1139,-118.4068
2018,Los Angeles,California,0,5,5,34.1139,-118.4068
2018,Modesto,California,0,5,5,37.6374,-121.0028
2018,Modesto,California,0,4,4,37.6374,-121.0028
2018,Oakland,California,0,4,4,37.7903,-122.2165
2018,Oakland,California,0,6,6,37.7903,-122.2165
2018,Oakland,California,2,2,4,37.7903,-122.2165
2018,Oakland,California,1,3,4,37.7903,-122.2165
2018,Riverside,California,0,7,7,33.9381,-117.3948
2018,San Bernardino,California,0,8,8,34.1412,-117.2936
2018,San Bernardino,California,1,3,4,34.1412,-117.2936
2018,San Diego,California,0,5,5,32.8312,-117.1226
2018,San Francisco,California,1,4,5,37.7562,-122.443
2018,San Francisco,California,1,5,6,37.7562,-122.443
2018,San Francisco,California,1,5,6,37.7562,-122.443
2018,Stockton,California,3,2,5,37.9766,-121.3112
2018,Thousand Oaks,California,12,22,34,34.1914,-118.8755
2018,Tracy,California,1,4,5,37.726,-121.444
2018,Union City,California,0,5,5,37.603,-122.0187
2018,Vallejo,California,2,3,5,38.1133,-122.2359
2018,Vallejo,California,0,4,4,38.1133,-122.2359
2018,Valley Village,California,0,6,6,34.16488,-118.3965
2018,Yountville,California,5,0,5,38.3956,-122.3669
2018,Aurora,Colorado,1,3,4,39.7084,-104.7274
2018,Colorado Springs,Colorado,1,3,4,38.8674,-104.7606
2018,Colorado Springs,Colorado,2,4,6,38.8674,-104.7606
2018,Denver,Colorado,1,3,4,39.7621,-104.8759
2018,Denver,Colorado,0,4,4,39.7621,-104.8759
2018,Thornton,Colorado,1,3,4,39.9205,-104.9443
2018,Westminster,Colorado,1,3,4,39.8837,-105.0627
2018,Bridgeport,Connecticut,0,4,4,41.1909,-73.1958
2018,Hartford,Connecticut,0,4,4,41.7661,-72.6834
2018,Prices Corner,Delaware,5,0,5,39.73694444,-75.62222222
2018,Washington,District of Columbia,1,4,5,38.9047,-77.0163
2018,Washington,District of Columbia,0,4,4,38.9047,-77.0163
2018,Washington,District of Columbia,0,4,4,38.9047,-77.0163
2018,Washington,District of Columbia,0,4,4,38.9047,-77.0163
2018,Washington,District of Columbia,1,3,4,38.9047,-77.0163
2018,Alachua,Florida,0,5,5,29.778,-82.4827
2018,Bradenton,Florida,1,5,6,27.49,-82.5743
2018,Indiantown,Florida,0,4,4,27.0386,-80.4699
2018,Jacksonville,Florida,0,6,6,30.3322,-81.6749
2018,Jacksonville,Florida,3,11,14,30.3322,-81.6749
2018,Jacksonville,Florida,3,1,4,30.3322,-81.6749
2018,Jacksonville,Florida,0,4,4,30.3322,-81.6749
2018,Lake Worth,Florida,3,3,6,26.6194,-80.059
2018,Macclenny,Florida,0,4,4,30.2816,-82.1249
2018,Miami,Florida,0,5,5,25.784,-80.2102
2018,Miami,Florida,0,5,5,25.784,-80.2102
2018,Miami,Florida,2,2,4,25.784,-80.2102
2018,Miami,Florida,2,2,4,25.784,-80.2102
2018,Miami,Florida,0,4,4,25.784,-80.2102
2018,Orlando,Florida,2,2,4,28.4788,-81.342
2018,Orlando,Florida,1,4,5,28.4788,-81.342
2018,Orlando,Florida,5,1,6,28.4788,-81.342
2018,Orlando,Florida,0,4,4,28.4788,-81.342
2018,Palm Beach Gardens,Florida,2,4,6,26.8488,-80.1656
2018,Palm Beach Gardens,Florida,1,3,4,26.8488,-80.1656
2018,Palm Beach Gardens,Florida,1,3,4,26.8488,-80.1656
2018,Parkland,Florida,17,17,34,26.3218,-80.2532
2018,Plantation,Florida,0,4,4,26.126,-80.2617
2018,Pompano Beach,Florida,0,4,4,26.2428,-80.1312
2018,Punta Gorda,Florida,0,4,4,26.8932,-82.0517
2018,Reddick,Florida,0,4,4,29.3687,-82.1974
2018,Tallahassee,Florida,3,5,8,30.455,-84.2526
2018,West Palm Beach,Florida,1,3,4,26.7467,-80.1314
2018,Ashburn,Georgia,1,6,7,31.7096,-83.6528
2018,Atlanta,Georgia,0,4,4,33.7626,-84.4228
2018,Atlanta,Georgia,1,3,4,33.7626,-84.4228
2018,Columbus,Georgia,0,5,5,32.51,-84.8771
2018,Macon,Georgia,1,3,4,32.8407,-83.6324
2018,Savannah,Georgia,0,4,4,32.0282,-81.1786
2018,Swainsboro,Georgia,0,4,4,32.5866,-82.3345
2018,Aurora,Illinois,0,7,7,41.7638,-88.2901
2018,Bloomington,Illinois,3,1,4,40.4757,-88.9705
2018,Bloomington,Illinois,2,2,4,40.4757,-88.9705
2018,Champaign,Illinois,1,3,4,40.1144,-88.2735
2018,Chicago,Illinois,4,0,4,41.8373,-87.6861
2018,Chicago,Illinois,0,5,5,41.8373,-87.6861
2018,Chicago,Illinois,0,6,6,41.8373,-87.6861
2018,Chicago,Illinois,2,2,4,41.8373,-87.6861
2018,Chicago,Illinois,0,5,5,41.8373,-87.6861
2018,Chicago,Illinois,0,7,7,41.8373,-87.6861
2018,Chicago,Illinois,1,4,5,41.8373,-87.6861
2018,Chicago,Illinois,0,4,4,41.8373,-87.6861
2018,Chicago,Illinois,0,4,4,41.8373,-87.6861
2018,Chicago,Illinois,0,8,8,41.8373,-87.6861
2018,Chicago,Illinois,1,5,6,41.8373,-87.6861
2018,Chicago,Illinois,1,3,4,41.8373,-87.6861
2018,Chicago,Illinois,0,4,4,41.8373,-87.6861
2018,Chicago,Illinois,0,4,4,41.8373,-87.6861
2018,Chicago,Illinois,0,5,5,41.8373,-87.6861
2018,Chicago,Illinois,2,5,7,41.8373,-87.6861
2018,Chicago,Illinois,0,6,6,41.8373,-87.6861
2018,Chicago,Illinois,0,6,6,41.8373,-87.6861
2018,Chicago,Illinois,1,4,5,41.8373,-87.6861
2018,Chicago,Illinois,0,4,4,41.8373,-87.6861
2018,Chicago,Illinois,2,3,5,41.8373,-87.6861
2018,Chicago,Illinois,0,4,4,41.8373,-87.6861
2018,Chicago,Illinois,1,5,6,41.8373,-87.6861
2018,Chicago,Illinois,1,3,4,41.8373,-87.6861
2018,Chicago,Illinois,1,4,5,41.8373,-87.6861
2018,Chicago,Illinois,0,4,4,41.8373,-87.6861
2018,Chicago Heights,Illinois,0,4,4,41.5101,-87.6347
2018,Harvey,Illinois,0,4,4,41.6076,-87.6521
2018,Robbins,Illinois,1,4,5,41.6431,-87.708
2018,Rockford,Illinois,1,4,5,42.2598,-89.0641
2018,Anderson,Indiana,0,4,4,40.0874,-85.692
2018,Fort Wayne,Indiana,3,2,5,41.0885,-85.1436
2018,Gary,Indiana,1,3,4,41.5906,-87.3472
2018,Gary,Indiana,1,3,4,41.5906,-87.3472
2018,Indianapolis,Indiana,2,2,4,39.7771,-86.1458
2018,Indianapolis,Indiana,1,4,5,39.7771,-86.1458
2018,Indianapolis,Indiana,2,3,5,39.7771,-86.1458
2018,South Bend,Indiana,0,6,6,41.6771,-86.2692
2018,Kansas City,Kansas,1,7,8,39.1234,-94.7443
2018,Wichita,Kansas,0,4,4,37.6897,-97.3442
2018,Benton,Kentucky,2,16,18,36.8512,-88.3594
2018,Bowling Green,Kentucky,0,4,4,36.9721,-86.4367
2018,Louisville,Kentucky,0,7,7,38.1662,-85.6488
2018,Louisville,Kentucky,2,0,2,38.1662,-85.6488
2018,Paintsville,Kentucky,5,0,5,37.8167,-82.8089
2018,Baton Rouge,Louisiana,3,1,4,30.4423,-91.1314
2018,Lutcher,Louisiana,2,2,4,30.0646,-90.7124
2018,Morganza,Louisiana,0,4,4,30.7383,-91.592
2018,Natachitoches,Louisiana,1,3,4,31.69305556,-93.095
2018,New Orleans,Louisiana,3,7,10,30.0687,-89.9288
2018,New Orleans,Louisiana,0,4,4,30.0687,-89.9288
2018,New Orleans,Louisiana,0,5,5,30.0687,-89.9288
2018,New Orleans,Louisiana,1,5,6,30.0687,-89.9288
2018,New Orleans,Louisiana,2,2,4,30.0687,-89.9288
2018,New Orleans,Louisiana,3,5,8,30.0687,-89.9288
2018,Shreveport,Louisiana,0,4,4,32.4659,-93.7959
2018,Shreveport,Louisiana,0,6,6,32.4659,-93.7959
2018,Aberdeen,Maryland,4,3,7,39.5146,-76.173
2018,Annapolis,Maryland,5,2,7,38.9706,-76.5047
2018,Baltimore,Maryland,0,5,5,39.3051,-76.6144
2018,Baltimore,Maryland,0,4,4,39.3051,-76.6144
2018,Baltimore,Maryland,0,6,6,39.3051,-76.6144
2018,Baltimore,Maryland,0,4,4,39.3051,-76.6144
2018,Fort Washington,Maryland,0,4,4,38.7339,-77.0069
2018,Perryman,Maryland,3,3,6,39.4633,-76.2115
2018,Silver Spring,Maryland,4,1,5,39.0028,-77.0207
2018,Boston,Massachusetts,0,4,4,42.3188,-71.0846
2018,Detroit,Michigan,1,3,4,42.3834,-83.1024
2018,Detroit,Michigan,1,3,4,42.3834,-83.1024
2018,Detroit,Michigan,0,4,4,42.3834,-83.1024
2018,Detroit,Michigan,5,0,5,42.3834,-83.1024
2018,Detroit,Michigan,4,3,7,42.3834,-83.1024
2018,Flint,Michigan,0,4,4,43.0236,-83.6922
2018,Lansing,Michigan,0,4,4,42.7142,-84.56
2018,Saginaw,Michigan,0,5,5,43.4199,-83.9501
2018,Saginaw,Michigan,0,5,5,43.4199,-83.9501
2018,Minneapolis,Minnesota,0,5,5,44.9635,-93.2678
2018,Minneapolis,Minnesota,0,6,6,44.9635,-93.2678
2018,Byhalia,Mississippi,0,4,4,34.869,-89.689
2018,Hattiesburg,Mississippi,0,6,6,31.3072,-89.3168
2018,Hazlehurst,Mississippi,1,7,8,31.8645,-90.3926
2018,Kansas City,Missouri,0,6,6,39.1239,-94.5541
2018,Saint Louis,Missouri,0,4,4,38.6358,-90.2451
2018,Saint Louis,Missouri,1,5,6,38.6358,-90.2451
2018,Saint Louis,Missouri,0,4,4,38.6358,-90.2451
2018,Saint Louis,Missouri,0,4,4,38.6358,-90.2451
2018,Saint Louis,Missouri,3,1,4,38.6358,-90.2451
2018,Saint Louis,Missouri,0,4,4,38.6358,-90.2451
2018,Saint Robert,Missouri,2,2,4,37.8234,-92.1514
2018,Springfield,Missouri,0,7,7,37.1943,-93.2915
2018,Springfield,Missouri,2,2,4,37.1943,-93.2915
2018,St. Charles,Missouri,4,1,5,38.7881,-90.4974
2018,St. Louis,Missouri,0,4,4,38.62722222,-90.19777778
2018,St. Louis,Missouri,0,4,4,38.62722222,-90.19777778
2018,St. Louis,Missouri,0,4,4,38.62722222,-90.19777778
2018,Omaha,Nebraska,1,6,7,41.2628,-96.0495
2018,Omaha,Nebraska,0,7,7,41.2628,-96.0495
2018,Omaha,Nebraska,0,4,4,41.2628,-96.0495
2018,Las Vegas,Nevada,0,4,4,36.2291,-115.2607
2018,Las Vegas,Nevada,0,4,4,36.2291,-115.2607
2018,North Las Vegas,Nevada,3,1,4,36.288,-115.0901
2018,North Las Vegas,Nevada,0,6,6,36.288,-115.0901
2018,Asbury Park,New Jersey,0,5,5,40.2226,-74.0117
2018,Camden,New Jersey,0,4,4,39.9361,-75.1073
2018,Elizabeth,New Jersey,0,4,4,40.6657,-74.1912
2018,Jersey City,New Jersey,1,3,4,40.7161,-74.0682
2018,Jersey City,New Jersey,0,5,5,40.7161,-74.0682
2018,Paterson,New Jersey,0,4,4,40.9147,-74.1624
2018,Paulsboro,New Jersey,0,4,4,39.84,-75.2397
2018,Trenton,New Jersey,0,5,5,40.2237,-74.764
2018,Trenton,New Jersey,1,22,23,40.2237,-74.764
2018,Española,New Mexico,1,3,4,36.004,-106.0671
2018,Tsayatoh,New Mexico,4,1,5,37.2003,-91.8699
2018,Albany,New York,0,4,4,42.6664,-73.7987
2018,Bronx,New York,0,4,4,40.8501,-73.8662
2018,Bronx,New York,0,4,4,40.8501,-73.8662
2018,Brooklyn,New York,0,4,4,40.6501,-73.9496
2018,Brooklyn,New York,1,4,5,40.6501,-73.9496
2018,Brooklyn,New York,1,3,4,40.6501,-73.9496
2018,Buffalo,New York,2,2,4,42.9017,-78.8487
2018,Buffalo,New York,1,4,5,42.9017,-78.8487
2018,Buffalo,New York,0,5,5,42.9017,-78.8487
2018,New York City,New York,0,5,5,40.7128,-74.006
2018,Watertown,New York,0,5,5,43.9734,-75.9094
2018,Asheville,North Carolina,4,3,7,35.5706,-82.5537
2018,Charlotte,North Carolina,0,4,4,35.2079,-80.8303
2018,Dunn,North Carolina,3,1,4,35.3113,-78.6129
2018,Henderson,North Carolina,0,4,4,36.3259,-78.4155
2018,Hickory,North Carolina,1,3,4,35.7427,-81.3233
2018,Kannapolis,North Carolina,0,4,4,35.4764,-80.6404
2018,Laurinburg,North Carolina,1,3,4,34.7596,-79.4781
2018,Maxton,North Carolina,0,5,5,34.7364,-79.3528
2018,Monroe,North Carolina,1,3,4,35.0061,-80.5593
2018,Sanford,North Carolina,1,6,7,35.4822,-79.1773
2018,Wadesboro,North Carolina,3,1,4,34.9645,-80.0746
2018,Cincinnati,Ohio,4,2,6,39.1412,-84.5059
2018,Cincinnati,Ohio,0,4,4,39.1412,-84.5059
2018,Cleveland,Ohio,3,2,5,41.4767,-81.6805
2018,Cleveland,Ohio,1,7,8,41.4767,-81.6805
2018,Cleveland,Ohio,1,3,4,41.4767,-81.6805
2018,Cleveland,Ohio,1,6,7,41.4767,-81.6805
2018,Cleveland,Ohio,1,5,6,41.4767,-81.6805
2018,Columbus,Ohio,0,4,4,39.986,-82.9852
2018,Lima,Ohio,1,3,4,40.7409,-84.1121
2018,Lima,Ohio,1,5,6,40.7409,-84.1121
2018,Sandusky,Ohio,0,5,5,41.4437,-82.7149
2018,Oklahoma City,Oklahoma,0,4,4,35.4676,-97.5136
2018,Oklahoma City,Oklahoma,1,3,4,35.4676,-97.5136
2018,Stillwater,Oklahoma,0,4,4,36.1315,-97.0739
2018,Talihina,Oklahoma,1,4,5,34.7523,-95.041
2018,Tulsa,Oklahoma,0,4,4,36.1284,-95.9042
2018,Homestead,Pennsylvania,1,3,4,40.4074,-79.9097
2018,Masontown,Pennsylvania,1,4,5,39.8488,-79.908
2018,Melcroft,Pennsylvania,4,1,5,40.052151,-79.389166
2018,Philadelphia,Pennsylvania,0,4,4,40.0076,-75.134
2018,Philadelphia,Pennsylvania,4,0,4,40.0076,-75.134
2018,Philadelphia,Pennsylvania,1,4,5,40.0076,-75.134
2018,Philadelphia,Pennsylvania,0,4,4,40.0076,-75.134
2018,Philadelphia,Pennsylvania,2,4,6,40.0076,-75.134
2018,Philadelphia,Pennsylvania,1,4,5,40.0076,-75.134
2018,Philadelphia,Pennsylvania,0,4,4,40.0076,-75.134
2018,Philadelphia,Pennsylvania,1,4,5,40.0076,-75.134
2018,Philadelphia,Pennsylvania,2,2,4,40.0076,-75.134
2018,Philadelphia,Pennsylvania,0,4,4,40.0076,-75.134
2018,Pittsburgh,Pennsylvania,11,6,17,40.4396,-79.9763
2018,Pittsburgh,Pennsylvania,0,4,4,40.4396,-79.9763
2018,Reading,Pennsylvania,4,0,4,40.34,-75.9266
2018,Wyncote,Pennsylvania,0,5,5,40.0914,-75.1463
2018,York,Pennsylvania,0,4,4,39.9651,-76.7315
2018,Florence,South Carolina,1,7,8,34.1785,-79.7857
2018,Greenwood,South Carolina,0,5,5,34.1944,-82.1543
2018,Spartanburg,South Carolina,0,6,6,34.9437,-81.9257
2018,Timmonsville,South Carolina,3,2,5,34.1334,-79.9408
2018,Chattanooga,Tennessee,0,5,5,35.0657,-85.2488
2018,Columbia,Tennessee,5,0,5,35.6225,-87.0478
2018,Covington,Tennessee,0,4,4,35.5656,-89.648
2018,Jackson,Tennessee,1,4,5,35.6533,-88.8352
2018,Memphis,Tennessee,2,4,6,35.1047,-89.9773
2018,Memphis,Tennessee,0,5,5,35.1047,-89.9773
2018,Memphis,Tennessee,3,2,5,35.1047,-89.9773
2018,Memphis,Tennessee,0,6,6,35.1047,-89.9773
2018,Memphis,Tennessee,0,5,5,35.1047,-89.9773
2018,Memphis,Tennessee,0,4,4,35.1047,-89.9773
2018,Memphis,Tennessee,2,4,6,35.1047,-89.9773
2018,Memphis,Tennessee,0,5,5,35.1047,-89.9773
2018,Nashville,Tennessee,4,4,8,36.1714,-86.7844
2018,Nashville,Tennessee,1,4,5,36.1714,-86.7844
2018,Nashville,Tennessee,4,2,6,36.1714,-86.7844
2018,Nashville,Tennessee,3,2,5,36.1714,-86.7844
2018,Powell,Tennessee,0,4,4,36.0317,-84.028
2018,Wartburg,Tennessee,0,4,4,36.1038,-84.5859
2018,Dallas,Texas,0,6,6,32.7937,-96.7662
2018,Dallas,Texas,0,5,5,32.7937,-96.7662
2018,Fort Worth,Texas,0,4,4,32.7814,-97.3473
2018,Houston,Texas,1,6,7,29.7868,-95.3905
2018,Houston,Texas,1,3,4,29.7868,-95.3905
2018,Houston,Texas,0,4,4,29.7868,-95.3905
2018,Houston,Texas,1,3,4,29.7868,-95.3905
2018,Plano,Texas,1,3,4,33.0502,-96.7487
2018,Ponder,Texas,5,1,6,33.1776,-97.2909
2018,Robstown,Texas,5,0,5,27.7886,-97.6685
2018,San Antonio,Texas,0,4,4,29.4722,-98.5247
2018,San Antonio,Texas,0,5,5,29.4722,-98.5247
2018,Santa Fe,Texas,10,14,24,29.3891,-95.1005
2018,Taft,Texas,4,1,5,27.9801,-97.3911
2018,Wichita Falls,Texas,1,3,4,33.9072,-98.5293
2018,Salt Lake City,Utah,0,4,4,40.7774,-111.9301
2018,Richmond,Virginia,0,6,6,37.5295,-77.4756
2018,Richmond,Virginia,1,3,4,37.5295,-77.4756
2018,Virginia Beach,Virginia,0,6,6,36.7335,-76.0435
2018,Virginia Beach,Virginia,1,3,4,36.7335,-76.0435
2018,Bryn Mawr-Skyway,Washington,2,2,4,47.4924,-122.2391
2018,Lakewood,Washington,1,3,4,47.1628,-122.5299
2018,Sunnyside,Washington,1,4,5,46.3159,-120.0058
2018,Madison,Wisconsin,0,4,4,43.0808,-89.3922
2018,Middleton,Wisconsin,1,3,4,43.1064,-89.5059
2018,Milwaukee,Wisconsin,0,4,4,43.064,-87.9669
2018,Wheatland,Wisconsin,1,3,4,42.5939,-88.2084
2019,Birmingham,Alabama,2,2,4,33.5276,-86.7988
2019,Birmingham,Alabama,0,5,5,33.5276,-86.7988
2019,Mobile,Alabama,2,3,5,30.6783,-88.1162
2019,Phoenix,Arizona,3,2,5,33.5722,-112.0891
2019,Phoenix,Arizona,0,7,7,33.5722,-112.0891
2019,Phoenix,Arizona,2,4,6,33.5722,-112.0891
2019,Phoenix,Arizona,1,5,6,33.5722,-112.0891
2019,Jonesboro,Arkansas,1,3,4,35.8212,-90.6795
2019,Little Rock,Arkansas,1,4,5,34.7255,-92.3581
2019,Pine Bluff,Arkansas,1,4,5,34.2116,-92.0178
2019,Los Angeles,California,1,4,5,34.1139,-118.4068
2019,Oakland,California,0,4,4,37.7903,-122.2165
2019,Oakland,California,1,4,5,37.7903,-122.2165
2019,Palmdale,California,3,1,4,34.5944,-118.1057
2019,San Diego,California,0,4,4,32.8312,-117.1226
2019,San Francisco,California,1,5,6,37.7562,-122.443
2019,Tehama County,California,6,12,18,40.17666667,-122.2380556
2019,Torrance,California,3,4,7,33.8346,-118.3417
2019,Denver,Colorado,1,4,5,39.7621,-104.8759
2019,Wilmington,Delaware,0,6,6,39.7415,-75.5413
2019,Washington,District of Columbia,0,5,5,38.9047,-77.0163
2019,Jacksonville,Florida,2,2,4,30.3322,-81.6749
2019,Jacksonville,Florida,3,2,5,30.3322,-81.6749
2019,Jacksonville,Florida,1,5,6,30.3322,-81.6749
2019,Miami,Florida,0,4,4,25.784,-80.2102
2019,Panama City,Florida,1,3,4,30.1997,-85.6003
2019,Sebring,Florida,5,0,5,27.477,-81.453
2019,Tallahassee,Florida,0,4,4,30.455,-84.2526
2019,Tallahassee,Florida,0,5,5,30.455,-84.2526
2019,Albany,Georgia,0,4,4,31.5776,-84.1762
2019,Atlanta,Georgia,1,4,5,33.7626,-84.4228
2019,Augusta,Georgia,0,4,4,33.3645,-82.0708
2019,Rochelle,Georgia,1,3,4,31.9488,-83.4568
2019,Rockmart,Georgia,4,1,5,34.0103,-85.0441
2019,Stockbridge,Georgia,3,2,5,33.5264,-84.2293
2019,Aurora,Illinois,6,6,12,41.7638,-88.2901
2019,Carbondale,Illinois,0,4,4,37.722,-89.2238
2019,Chicago,Illinois,0,6,6,41.8373,-87.6861
2019,Chicago,Illinois,1,4,5,41.8373,-87.6861
2019,Chicago,Illinois,0,6,6,41.8373,-87.6861
2019,Chicago,Illinois,2,5,7,41.8373,-87.6861
2019,Chicago,Illinois,0,4,4,41.8373,-87.6861
2019,Harvey,Illinois,1,3,4,41.6076,-87.6521
2019,Evansville,Indiana,0,5,5,37.9882,-87.5339
2019,Indianapolis,Indiana,2,3,5,39.7771,-86.1458
2019,Indianapolis,Indiana,0,5,5,39.7771,-86.1458
2019,Covington,Kentucky,0,5,5,39.0334,-84.5166
2019,Elizabethtown,Kentucky,2,2,4,37.703,-85.8772
2019,Owensboro,Kentucky,3,1,4,37.7575,-87.1172
2019,Ascension Parish,Louisiana,5,0,5,30.1,-90.99416667
2019,Baton Rouge,Louisiana,0,4,4,30.4423,-91.1314
2019,New Orleans,Louisiana,1,5,6,30.0687,-89.9288
2019,Shreveport,Louisiana,0,4,4,32.4659,-93.7959
2019,Shreveport,Louisiana,0,4,4,32.4659,-93.7959
2019,Baltimore,Maryland,0,4,4,39.3051,-76.6144
2019,Baltimore,Maryland,0,4,4,39.3051,-76.6144
2019,Baltimore,Maryland,1,4,5,39.3051,-76.6144
2019,Solon Township,Michigan,4,0,4,13.24361111,-85.61222222
2019,Clinton,Mississippi,4,0,5,32.354,-90.3403
2019,Hermanville,Mississippi,0,4,4,31.9593,-90.8401
2019,Kansas City,Missouri,0,4,4,39.1239,-94.5541
2019,Missoula,Montana,1,3,4,46.8685,-114.0094
2019,Las Vegas,Nevada,0,4,4,36.2291,-115.2607
2019,North Las Vegas,Nevada,0,5,5,36.288,-115.0901
2019,Camden,New Jersey,1,3,4,39.9361,-75.1073
2019,Newark,New Jersey,1,3,4,40.7245,-74.1725
2019,Paterson,New Jersey,0,4,4,40.9147,-74.1624
2019,Roswell,New Mexico,0,4,4,33.373,-104.5294
2019,Brooklyn,New York,1,3,4,40.6501,-73.9496
2019,Winston-Salem,North Carolina,0,6,6,36.1029,-80.261
2019,Cleveland,Ohio,1,3,4,41.4767,-81.6805
2019,Lebanon,Pennsylvania,0,4,4,40.3412,-76.4228
2019,State College,Pennsylvania,4,1,5,40.7909,-77.8568
2019,Columbia,South Carolina,0,5,5,34.037,-80.9042
2019,Gaffney,South Carolina,1,4,5,35.0742,-81.6558
2019,North Charleston,South Carolina,0,7,7,32.9086,-80.0705
2019,Covington,Tennessee,0,4,4,35.5656,-89.648
2019,Henderson,Texas,2,2,4,32.1576,-94.796
2019,Houston,Texas,2,2,4,29.7868,-95.3905
2019,Houston,Texas,2,4,6,29.7868,-95.3905
2019,Houston,Texas,3,2,5,29.7868,-95.3905
2019,Houston,Texas,1,3,4,29.7868,-95.3905
2019,Livingston,Texas,5,0,5,30.71,-94.9381
2019,San Antonio,Texas,2,2,4,29.4722,-98.5247
2019,Texas City,Texas,3,1,4,29.4128,-94.9658
2019,Hurt,Virginia,3,2,5,37.0954,-79.3029
2019,Petersburg,Virginia,0,4,4,37.2043,-77.3913
